NO textures/koto_north.xpm
SO textures/koto_south.xpm
WE textures/koto_west.xpm
EA textures/koto_east.xpm

F 0,0,0
C 255,255,255

11111111
10000001
10000001
11000001
11111111
