NO textures/greystone.xpm
WE textures/eagle.xpm
EA textures/colorstone.xpm
SO textures/bookshelf.xpm

C 171,154,137
F 139,99,58

111111111111111
111111000111111
111110000011111
111100000001111
1110000N0000111
110000000000011
100001111100001
110000111000011
111000010000111
111100000001111
111110000011111
111111000111111
111111101111111

11111111
11111111
