NO textures/koto_north.xpm
SO textures/koto_south.xpm
WE textures/koto_west.xpm
EA textures/koto_east.xpm

F 220,100,0
C 225,30,0

        1111111111111111111111
        1000000000001100000001
        1011000000011100000001
        1001000000000000000001
111111111011000000011100000001
100000000011000001110111111111
1111011111111011100000010001
1111011111111011101010010001
1100000110101011100000010001
1000000000000001101010010001
1100001110101011111011110N0111
1111011 1110101 101111010001
1111111 1111111 111111111111