NO textures/koto_north.xpm
SO textures/koto_south.xpm
WE textures/koto_west.xpm
EA textures/koto_east.xpm

C 1,1,1
F 255,255,255

111111111111111111111111111111
100000000000000000000000000001
101111111111111111111111111101
101000000000000000000000000001
101011111111111111111111111101
101010000000000000000000000001
101010111111111111111111010101
101010000000000000000000000001
101011111111111111111111111101
101010000000000000000000000001
101010111111111111111111010101
10101N000000000000000000000001
101011111111111111111111111101
101000000000000000000000000001
101111111111111111111111111101
100000000000000000000000000001
101111111111111111111111111101
100000000000000000000000000001
111111111111111111111111111111